
  11      11





     1111







      11


  11      11






1     11     1
 1          1
  1        1
   1      1
    1    1
     1  1
      11






